Year,Week,Deceased Males,Deceased Females,Deceased Transgender,Total Deceased
2000,1,588,365,0,953
2001,1,513,389,0,902
2002,1,570,325,0,895
2003,1,551,387,0,938
2004,1,502,321,0,823
2005,1,480,348,0,828
2006,1,615,436,0,1051
2007,1,615,434,0,1049
2008,1,590,385,0,975
2009,1,622,436,0,1058
2010,1,728,479,0,1207
2011,1,708,453,0,1161
2012,1,826,482,0,1308
2013,1,677,419,0,1096
2014,1,753,471,0,1224
2015,1,755,489,0,1244
2016,1,776,541,0,1317
2017,1,787,547,0,1334
2018,1,799,577,0,1376
2019,1,793,536,1,1330
2020,1,784,541,0,1325
2021,1,860,550,0,1410
2000,2,552,385,0,937
2001,2,521,362,0,883
2002,2,520,323,0,843
2003,2,561,383,0,944
2004,2,479,344,0,823
2005,2,490,355,0,845
2006,2,557,400,0,957
2007,2,579,383,0,962
2008,2,598,420,0,1018
2009,2,669,455,0,1124
2010,2,782,485,0,1267
2011,2,767,488,0,1255
2012,2,668,449,0,1117
2013,2,657,416,0,1073
2014,2,653,448,0,1101
2015,2,716,489,0,1205
2016,2,771,501,0,1272
2017,2,745,479,0,1224
2018,2,746,517,0,1263
2019,2,826,594,0,1420
2020,2,735,511,2,1248
2021,2,789,596,0,1385
2000,3,451,307,0,758
2001,3,503,338,0,841
2002,3,555,343,0,898
2003,3,530,382,0,912
2004,3,490,363,0,853
2005,3,506,364,0,870
2006,3,584,449,0,1033
2007,3,606,418,0,1024
2008,3,567,454,0,1021
2009,3,634,425,0,1059
2010,3,711,443,0,1154
2011,3,755,418,0,1173
2012,3,735,473,0,1208
2013,3,711,433,0,1144
2014,3,709,432,0,1141
2015,3,676,497,0,1173
2016,3,805,542,0,1347
2017,3,781,535,0,1316
2018,3,748,534,0,1282
2019,3,826,571,0,1397
2020,3,845,549,0,1394
2021,3,859,584,0,1443
2000,4,523,364,0,887
2001,4,486,286,0,772
2002,4,503,304,0,807
2003,4,570,329,0,899
2004,4,475,305,0,780
2005,4,466,315,0,781
2006,4,599,401,0,1000
2007,4,578,392,0,970
2008,4,638,436,0,1074
2009,4,657,446,0,1103
2010,4,677,445,0,1122
2011,4,738,480,0,1218
2012,4,733,463,0,1196
2013,4,725,445,0,1170
2014,4,679,486,0,1165
2015,4,770,554,0,1324
2016,4,710,518,0,1228
2017,4,783,584,0,1367
2018,4,732,532,0,1264
2019,4,815,607,0,1422
2020,4,800,524,0,1324
2021,4,821,581,0,1402
2000,5,545,361,0,906
2001,5,520,372,0,892
2002,5,466,305,0,771
2003,5,583,427,0,1010
2004,5,465,311,0,776
2005,5,479,328,0,807
2006,5,605,445,0,1050
2007,5,566,382,0,948
2008,5,620,406,0,1026
2009,5,647,430,0,1077
2010,5,650,424,0,1074
2011,5,671,455,0,1126
2012,5,686,464,0,1150
2013,5,669,457,0,1126
2014,5,682,459,0,1141
2015,5,691,460,0,1151
2016,5,730,465,0,1195
2017,5,757,496,2,1255
2018,5,775,565,0,1340
2019,5,747,550,0,1297
2020,5,749,548,0,1297
2021,5,762,565,0,1327
2000,6,562,335,0,897
2001,6,491,347,0,838
2002,6,519,312,0,831
2003,6,531,338,0,869
2004,6,447,329,0,776
2005,6,487,345,0,832
2006,6,566,404,0,970
2007,6,593,404,0,997
2008,6,580,412,0,992
2009,6,590,410,0,1000
2010,6,680,448,0,1128
2011,6,648,487,0,1135
2012,6,643,450,0,1093
2013,6,712,433,0,1145
2014,6,670,443,0,1113
2015,6,706,532,0,1238
2016,6,701,439,0,1140
2017,6,731,473,0,1204
2018,6,796,593,0,1389
2019,6,754,514,0,1268
2020,6,791,515,0,1306
2021,6,771,537,0,1308
2000,7,551,332,0,883
2001,7,372,346,0,718
2002,7,516,304,0,820
2003,7,528,358,0,886
2004,7,481,316,0,797
2005,7,521,348,0,869
2006,7,614,395,0,1009
2007,7,531,367,0,898
2008,7,583,388,0,971
2009,7,588,395,0,983
2010,7,654,438,0,1092
2011,7,659,435,0,1094
2012,7,712,457,0,1169
2013,7,686,440,0,1126
2014,7,646,466,0,1112
2015,7,724,496,0,1220
2016,7,712,459,0,1171
2017,7,742,503,0,1245
2018,7,758,519,1,1278
2019,7,757,526,0,1283
2020,7,754,526,0,1280
2021,7,833,531,0,1364
2000,8,549,313,0,862
2001,8,524,335,0,859
2002,8,475,323,0,798
2003,8,476,293,0,769
2004,8,435,320,0,755
2005,8,467,340,0,807
2006,8,478,387,0,865
2007,8,556,327,0,883
2008,8,527,359,0,886
2009,8,563,381,0,944
2010,8,629,400,0,1029
2011,8,644,400,0,1044
2012,8,622,429,0,1051
2013,8,605,430,0,1035
2014,8,696,403,0,1099
2015,8,691,472,0,1163
2016,8,687,461,0,1148
2017,8,736,524,0,1260
2018,8,787,490,0,1277
2019,8,743,508,0,1251
2020,8,726,496,1,1223
2021,8,784,518,0,1302
2000,9,512,330,0,842
2001,9,471,328,0,799
2002,9,473,281,0,754
2003,9,462,307,0,769
2004,9,446,341,0,787
2005,9,501,326,0,827
2006,9,484,355,0,839
2007,9,538,374,0,912
2008,9,598,411,0,1009
2009,9,560,402,0,962
2010,9,632,415,0,1047
2011,9,650,457,0,1107
2012,9,646,391,0,1037
2013,9,649,431,0,1080
2014,9,663,441,0,1104
2015,9,709,451,0,1160
2016,9,641,435,0,1076
2017,9,691,476,1,1168
2018,9,701,487,0,1188
2019,9,761,541,0,1302
2020,9,694,516,0,1210
2021,9,785,516,0,1301
2000,10,450,335,0,785
2001,10,532,354,0,886
2002,10,493,293,0,786
2003,10,470,303,0,773
2004,10,470,326,0,796
2005,10,504,330,0,834
2006,10,499,346,0,845
2007,10,479,358,0,837
2008,10,588,385,0,973
2009,10,552,375,0,927
2010,10,600,412,0,1012
2011,10,704,444,0,1148
2012,10,675,427,0,1102
2013,10,671,461,0,1132
2014,10,586,416,0,1002
2015,10,711,488,0,1199
2016,10,676,406,0,1082
2017,10,697,499,0,1196
2018,10,706,461,0,1167
2019,10,739,513,0,1252
2020,10,675,464,0,1139
2021,10,774,539,0,1313
2000,11,559,346,0,905
2001,11,446,297,0,743
2002,11,480,310,0,790
2003,11,506,303,0,809
2004,11,433,370,0,803
2005,11,496,330,0,826
2006,11,493,353,0,846
2007,11,482,357,0,839
2008,11,558,379,0,937
2009,11,556,354,0,910
2010,11,562,409,0,971
2011,11,630,376,0,1006
2012,11,684,435,0,1119
2013,11,654,395,0,1049
2014,11,676,417,0,1093
2015,11,660,469,0,1129
2016,11,658,433,0,1091
2017,11,667,485,1,1153
2018,11,740,470,0,1210
2019,11,738,464,0,1202
2020,11,671,489,0,1160
2021,11,760,504,0,1264
2000,12,416,400,0,816
2001,12,451,311,0,762
2002,12,444,307,0,751
2003,12,529,314,0,843
2004,12,417,300,0,717
2005,12,445,331,0,776
2006,12,492,335,0,827
2007,12,513,338,0,851
2008,12,545,346,0,891
2009,12,511,354,0,865
2010,12,542,367,0,909
2011,12,564,407,0,971
2012,12,578,369,0,947
2013,12,642,396,0,1038
2014,12,575,391,0,966
2015,12,628,438,0,1066
2016,12,639,376,0,1015
2017,12,629,418,0,1047
2018,12,707,477,0,1184
2019,12,703,503,1,1207
2020,12,678,470,1,1149
2021,12,735,554,0,1289
2000,13,490,342,0,832
2001,13,474,323,0,797
2002,13,430,307,0,737
2003,13,486,292,0,778
2004,13,403,305,0,708
2005,13,467,314,0,781
2006,13,512,319,0,831
2007,13,513,318,0,831
2008,13,542,401,0,943
2009,13,519,337,0,856
2010,13,587,408,0,995
2011,13,581,402,0,983
2012,13,626,367,0,993
2013,13,591,413,0,1004
2014,13,612,401,0,1013
2015,13,655,434,0,1089
2016,13,587,411,0,998
2017,13,667,424,0,1091
2018,13,633,450,0,1083
2019,13,660,483,0,1143
2020,13,575,446,0,1021
2021,13,851,594,1,1446
2000,14,392,343,0,735
2001,14,457,323,0,780
2002,14,433,312,0,745
2003,14,552,335,0,887
2004,14,434,275,0,709
2005,14,474,307,0,781
2006,14,479,325,0,804
2007,14,513,369,0,882
2008,14,527,408,0,935
2009,14,543,353,0,896
2010,14,589,386,0,975
2011,14,574,413,0,987
2012,14,611,375,0,986
2013,14,664,435,0,1099
2014,14,622,374,0,996
2015,14,608,415,0,1023
2016,14,640,458,0,1098
2017,14,647,471,0,1118
2018,14,627,453,0,1080
2019,14,665,447,0,1112
2020,14,544,428,0,972
2021,14,881,643,0,1524
2000,15,510,312,0,822
2001,15,460,274,0,734
2002,15,464,287,0,751
2003,15,487,285,0,772
2004,15,384,314,0,698
2005,15,472,312,0,784
2006,15,476,329,0,805
2007,15,527,350,0,877
2008,15,567,358,0,925
2009,15,539,384,0,923
2010,15,581,398,0,979
2011,15,590,443,0,1033
2012,15,621,382,0,1003
2013,15,664,440,0,1104
2014,15,622,427,0,1049
2015,15,618,393,0,1011
2016,15,637,417,0,1054
2017,15,611,414,0,1025
2018,15,620,483,0,1103
2019,15,695,446,0,1141
2020,15,532,400,0,932
2021,15,1023,712,1,1736
2000,16,504,270,0,774
2001,16,508,313,0,821
2002,16,457,282,0,739
2003,16,500,347,0,847
2004,16,444,340,0,784
2005,16,490,308,0,798
2006,16,491,349,0,840
2007,16,503,323,0,826
2008,16,572,420,0,992
2009,16,551,352,0,903
2010,16,558,371,0,929
2011,16,595,372,0,967
2012,16,631,414,0,1045
2013,16,700,462,0,1162
2014,16,597,395,0,992
2015,16,670,433,0,1103
2016,16,598,419,0,1017
2017,16,661,463,0,1124
2018,16,658,430,0,1088
2019,16,707,477,0,1184
2020,16,510,436,0,946
2021,16,1375,863,0,2238
2000,17,519,368,0,887
2001,17,450,333,0,783
2002,17,408,275,0,683
2003,17,466,276,0,742
2004,17,378,334,0,712
2005,17,481,367,0,848
2006,17,503,382,0,885
2007,17,497,334,0,831
2008,17,596,392,0,988
2009,17,567,381,0,948
2010,17,578,390,0,968
2011,17,638,399,0,1037
2012,17,655,416,0,1071
2013,17,667,448,0,1115
2014,17,647,379,0,1026
2015,17,635,409,0,1044
2016,17,706,456,0,1162
2017,17,652,506,0,1158
2018,17,661,494,0,1155
2019,17,658,455,0,1113
2020,17,532,449,0,981
2021,17,1931,1375,1,3307
2000,18,493,334,0,827
2001,18,538,340,0,878
2002,18,472,324,0,796
2003,18,560,350,0,910
2004,18,406,302,0,708
2005,18,487,314,0,801
2006,18,544,400,0,944
2007,18,511,378,0,889
2008,18,684,446,0,1130
2009,18,582,379,0,961
2010,18,570,397,0,967
2011,18,671,452,0,1123
2012,18,640,429,0,1069
2013,18,704,491,0,1195
2014,18,552,418,0,970
2015,18,607,437,0,1044
2016,18,622,443,0,1065
2017,18,637,436,0,1073
2018,18,667,465,0,1132
2019,18,748,516,0,1264
2020,18,554,461,0,1015
2021,18,2600,1876,1,4477
2000,19,543,364,0,907
2001,19,578,378,0,956
2002,19,552,384,0,936
2003,19,563,374,0,937
2004,19,505,318,0,823
2005,19,566,430,0,996
2006,19,526,370,0,896
2007,19,666,497,0,1163
2008,19,612,427,0,1039
2009,19,645,405,0,1050
2010,19,617,438,0,1055
2011,19,733,512,0,1245
2012,19,619,394,0,1013
2013,19,806,490,0,1296
2014,19,685,473,0,1158
2015,19,628,486,0,1114
2016,19,653,448,0,1101
2017,19,678,465,0,1143
2018,19,694,469,0,1163
2019,19,789,537,0,1326
2020,19,630,563,0,1193
2021,19,3013,2219,0,5232
2000,20,589,408,0,997
2001,20,536,456,0,992
2002,20,548,375,0,923
2003,20,601,390,0,991
2004,20,532,330,0,862
2005,20,581,453,0,1034
2006,20,549,348,0,897
2007,20,685,537,0,1222
2008,20,643,484,0,1127
2009,20,599,411,0,1010
2010,20,597,465,0,1062
2011,20,600,432,0,1032
2012,20,719,477,0,1196
2013,20,705,456,0,1161
2014,20,727,513,0,1240
2015,20,597,428,0,1025
2016,20,676,440,0,1116
2017,20,825,595,0,1420
2018,20,685,469,0,1154
2019,20,732,530,0,1262
2020,20,673,619,1,1293
2021,20,3044,2109,1,5154
2000,21,522,325,0,847
2001,21,518,380,0,898
2002,21,540,314,0,854
2003,21,711,477,0,1188
2004,21,532,358,0,890
2005,21,527,392,0,919
2006,21,565,333,0,898
2007,21,585,398,0,983
2008,21,589,453,0,1042
2009,21,609,447,0,1056
2010,21,714,465,0,1179
2011,21,652,389,0,1041
2012,21,840,601,0,1441
2013,21,774,503,0,1277
2014,21,854,579,0,1433
2015,21,805,597,0,1402
2016,21,756,488,0,1244
2017,21,787,604,1,1392
2018,21,686,444,1,1131
2019,21,750,551,0,1301
2020,21,1000,882,1,1883
2021,21,2404,1714,0,4118
2000,22,474,306,0,780
2001,22,504,321,0,825
2002,22,444,276,0,720
2003,22,738,533,0,1271
2004,22,482,323,0,805
2005,22,501,364,0,865
2006,22,497,331,0,828
2007,22,540,395,0,935
2008,22,527,342,0,869
2009,22,637,443,0,1080
2010,22,767,503,0,1270
2011,22,614,417,0,1031
2012,22,1058,877,0,1935
2013,22,711,434,0,1145
2014,22,781,497,0,1278
2015,22,654,445,0,1099
2016,22,702,499,0,1201
2017,22,796,631,0,1427
2018,22,723,539,0,1262
2019,22,729,579,0,1308
2020,22,1146,849,1,1996
2021,22,1830,1412,0,3242
2000,23,493,290,0,783
2001,23,431,283,0,714
2002,23,379,276,0,655
2003,23,593,397,0,990
2004,23,453,358,0,811
2005,23,546,388,0,934
2006,23,505,323,0,828
2007,23,558,365,0,923
2008,23,542,386,0,928
2009,23,660,473,0,1133
2010,23,673,455,0,1128
2011,23,642,436,0,1078
2012,23,869,655,0,1524
2013,23,646,405,0,1051
2014,23,788,539,0,1327
2015,23,637,431,0,1068
2016,23,626,446,0,1072
2017,23,704,518,0,1222
2018,23,764,502,1,1267
2019,23,833,608,1,1442
2020,23,1171,792,0,1963
2021,23,1234,953,0,2187
2000,24,543,333,0,876
2001,24,465,327,0,792
2002,24,454,301,0,755
2003,24,501,339,0,840
2004,24,460,340,0,800
2005,24,513,453,0,966
2006,24,542,350,0,892
2007,24,500,349,0,849
2008,24,521,339,0,860
2009,24,610,459,0,1069
2010,24,561,415,0,976
2011,24,605,374,0,979
2012,24,692,490,0,1182
2013,24,670,416,0,1086
2014,24,772,534,0,1306
2015,24,678,429,0,1107
2016,24,698,462,0,1160
2017,24,675,502,0,1177
2018,24,738,471,1,1210
2019,24,899,699,1,1599
2020,24,1079,809,0,1888
2021,24,993,796,0,1789
2000,25,478,272,0,750
2001,25,433,330,0,763
2002,25,444,229,0,673
2003,25,578,343,0,921
2004,25,467,356,0,823
2005,25,521,427,0,948
2006,25,515,333,0,848
2007,25,471,321,0,792
2008,25,506,349,0,855
2009,25,560,434,0,994
2010,25,581,331,0,912
2011,25,672,424,0,1096
2012,25,622,404,0,1026
2013,25,705,464,0,1169
2014,25,721,573,0,1294
2015,25,663,440,0,1103
2016,25,619,429,0,1048
2017,25,623,445,0,1068
2018,25,703,486,0,1189
2019,25,832,687,0,1519
2020,25,1014,770,0,1784
2021,25,846,645,0,1491
2000,26,450,302,0,752
2001,26,490,273,0,763
2002,26,496,287,0,783
2003,26,470,296,0,766
2004,26,458,310,0,768
2005,26,471,321,0,792
2006,26,518,323,0,841
2007,26,456,345,0,801
2008,26,493,325,0,818
2009,26,541,399,0,940
2010,26,558,366,0,924
2011,26,576,405,0,981
2012,26,537,376,0,913
2013,26,679,377,0,1056
2014,26,718,440,0,1158
2015,26,666,443,0,1109
2016,26,646,413,0,1059
2017,26,630,477,1,1108
2018,26,614,460,0,1074
2019,26,724,523,0,1247
2020,26,984,673,0,1657
2021,26,756,483,0,1239
2000,27,436,310,0,746
2001,27,427,281,0,708
2002,27,486,333,0,819
2003,27,468,303,0,771
2004,27,454,276,0,730
2005,27,448,317,0,765
2006,27,564,365,0,929
2007,27,559,375,0,934
2008,27,527,355,0,882
2009,27,488,338,0,826
2010,27,623,359,0,982
2011,27,604,352,0,956
2012,27,599,357,0,956
2013,27,595,324,0,919
2014,27,658,421,0,1079
2015,27,673,443,0,1116
2016,27,678,413,0,1091
2017,27,702,497,0,1199
2018,27,686,494,0,1180
2019,27,660,453,3,1116
2020,27,881,623,0,1504
2021,27,670,476,0,1146
2000,28,502,352,0,854
2001,28,401,285,0,686
2002,28,497,304,0,801
2003,28,440,305,0,745
2004,28,414,277,0,691
2005,28,434,328,0,762
2006,28,525,377,0,902
2007,28,525,351,0,876
2008,28,532,344,0,876
2009,28,574,341,0,915
2010,28,597,379,0,976
2011,28,635,418,0,1053
2012,28,594,379,0,973
2013,28,633,393,0,1026
2014,28,640,409,0,1049
2015,28,638,395,0,1033
2016,28,683,487,0,1170
2017,28,706,433,0,1139
2018,28,663,422,0,1085
2019,28,711,457,0,1168
2020,28,853,633,1,1487
2021,28,588,437,0,1025
2000,29,480,322,0,802
2001,29,397,266,0,663
2002,29,416,258,0,674
2003,29,443,293,0,736
2004,29,413,264,0,677
2005,29,449,311,0,760
2006,29,483,333,0,816
2007,29,496,341,0,837
2008,29,526,351,0,877
2009,29,544,376,0,920
2010,29,627,411,0,1038
2011,29,549,367,0,916
2012,29,622,381,0,1003
2013,29,613,376,0,989
2014,29,661,417,0,1078
2015,29,549,364,0,913
2016,29,677,440,0,1117
2017,29,688,463,0,1151
2018,29,710,482,0,1192
2019,29,698,434,0,1132
2020,29,840,511,0,1351
2021,29,569,395,0,964
2000,30,465,317,0,782
2001,30,431,258,0,689
2002,30,362,206,0,568
2003,30,517,353,0,870
2004,30,373,245,0,618
2005,30,490,283,0,773
2006,30,470,339,0,809
2007,30,535,298,0,833
2008,30,497,290,0,787
2009,30,537,379,0,916
2010,30,593,427,0,1020
2011,30,615,349,0,964
2012,30,634,396,0,1030
2013,30,649,444,0,1093
2014,30,614,392,0,1006
2015,30,630,386,0,1016
2016,30,560,422,0,982
2017,30,735,516,1,1252
2018,30,689,472,0,1161
2019,30,689,448,0,1137
2020,30,855,562,0,1417
2021,30,405,300,1,706
2000,31,429,309,0,738
2001,31,433,256,0,689
2002,31,398,268,0,666
2003,31,504,289,0,793
2004,31,466,294,0,760
2005,31,431,348,0,779
2006,31,508,365,0,873
2007,31,475,324,0,799
2008,31,519,373,0,892
2009,31,489,375,0,864
2010,31,693,420,0,1113
2011,31,601,368,0,969
2012,31,586,387,0,973
2013,31,671,456,0,1127
2014,31,580,425,0,1005
2015,31,595,379,0,974
2016,31,599,389,0,988
2017,31,638,463,0,1101
2018,31,611,428,0,1039
2019,31,731,477,1,1209
2020,31,830,571,0,1401
2021,31,110,85,0,195
2000,32,455,316,0,771
2001,32,448,307,0,755
2002,32,421,255,0,676
2003,32,510,323,0,833
2004,32,420,301,0,721
2005,32,428,371,0,799
2006,32,532,324,0,856
2007,32,549,372,0,921
2008,32,541,352,0,893
2009,32,531,349,0,880
2010,32,660,440,0,1100
2011,32,657,389,0,1046
2012,32,636,379,0,1015
2013,32,600,372,0,972
2014,32,651,344,0,995
2015,32,614,419,0,1033
2016,32,644,468,0,1112
2017,32,728,429,0,1157
2018,32,634,404,0,1038
2019,32,782,472,0,1254
2020,32,863,558,0,1421
2000,33,475,307,0,782
2001,33,440,270,0,710
2002,33,439,261,0,700
2003,33,491,340,0,831
2004,33,482,344,0,826
2005,33,471,301,0,772
2006,33,555,360,0,915
2007,33,512,360,0,872
2008,33,507,333,0,840
2009,33,519,316,0,835
2010,33,643,398,0,1041
2011,33,635,385,0,1020
2012,33,664,372,0,1036
2013,33,667,410,0,1077
2014,33,666,411,0,1077
2015,33,604,405,0,1009
2016,33,660,431,0,1091
2017,33,712,429,0,1141
2018,33,661,420,0,1081
2019,33,718,476,0,1194
2020,33,926,617,1,1544
2000,34,491,313,0,804
2001,34,472,296,0,768
2002,34,410,291,0,701
2003,34,496,347,0,843
2004,34,461,338,0,799
2005,34,472,331,0,803
2006,34,551,373,0,924
2007,34,524,378,0,902
2008,34,560,342,0,902
2009,34,513,354,0,867
2010,34,643,383,0,1026
2011,34,596,382,0,978
2012,34,632,424,0,1056
2013,34,697,385,0,1082
2014,34,624,371,0,995
2015,34,607,402,0,1009
2016,34,618,450,0,1068
2017,34,668,451,0,1119
2018,34,713,466,0,1179
2019,34,678,478,0,1156
2020,34,940,608,1,1549
2000,35,413,314,0,727
2001,35,499,297,0,796
2002,35,428,268,0,696
2003,35,500,334,0,834
2004,35,404,283,0,687
2005,35,444,334,0,778
2006,35,575,390,0,965
2007,35,511,335,0,846
2008,35,565,384,0,949
2009,35,515,343,0,858
2010,35,660,429,0,1089
2011,35,632,373,0,1005
2012,35,618,369,0,987
2013,35,696,400,0,1096
2014,35,685,426,0,1111
2015,35,603,419,0,1022
2016,35,606,392,0,998
2017,35,749,549,1,1299
2018,35,646,394,0,1040
2019,35,724,475,0,1199
2020,35,1022,704,0,1726
2000,36,529,354,0,883
2001,36,473,319,0,792
2002,36,418,252,0,670
2003,36,556,361,0,917
2004,36,377,281,0,658
2005,36,498,293,0,791
2006,36,605,432,0,1037
2007,36,609,334,0,943
2008,36,526,363,0,889
2009,36,615,377,0,992
2010,36,683,419,0,1102
2011,36,654,413,0,1067
2012,36,664,392,0,1056
2013,36,602,389,0,991
2014,36,636,380,0,1016
2015,36,639,402,0,1041
2016,36,635,417,0,1052
2017,36,818,512,0,1330
2018,36,700,445,0,1145
2019,36,772,502,1,1275
2020,36,1088,645,0,1733
2000,37,472,324,0,796
2001,37,466,289,0,755
2002,37,446,255,0,701
2003,37,478,345,0,823
2004,37,455,282,0,737
2005,37,512,358,0,870
2006,37,589,389,0,978
2007,37,556,358,0,914
2008,37,574,386,0,960
2009,37,619,430,0,1049
2010,37,703,411,0,1114
2011,37,723,418,0,1141
2012,37,684,377,0,1061
2013,37,689,384,0,1073
2014,37,671,432,0,1103
2015,37,642,383,0,1025
2016,37,636,420,0,1056
2017,37,812,471,0,1283
2018,37,665,458,0,1123
2019,37,780,546,0,1326
2020,37,990,550,0,1540
2000,38,420,301,0,721
2001,38,413,289,0,702
2002,38,442,305,0,747
2003,38,512,321,0,833
2004,38,410,271,0,681
2005,38,476,357,0,833
2006,38,573,412,0,985
2007,38,561,279,0,840
2008,38,554,384,0,938
2009,38,585,378,0,963
2010,38,698,475,0,1173
2011,38,630,383,0,1013
2012,38,621,431,0,1052
2013,38,725,436,0,1161
2014,38,625,451,0,1076
2015,38,699,384,0,1083
2016,38,658,434,0,1092
2017,38,827,574,0,1401
2018,38,663,435,0,1098
2019,38,757,457,0,1214
2020,38,1041,621,0,1662
2000,39,388,291,0,679
2001,39,476,262,0,738
2002,39,447,293,0,740
2003,39,472,275,0,747
2004,39,446,284,0,730
2005,39,457,343,0,800
2006,39,598,384,0,982
2007,39,571,393,0,964
2008,39,566,384,0,950
2009,39,591,392,0,983
2010,39,663,412,0,1075
2011,39,602,346,0,948
2012,39,661,407,0,1068
2013,39,690,429,0,1119
2014,39,653,416,0,1069
2015,39,637,394,0,1031
2016,39,674,428,0,1102
2017,39,783,532,1,1316
2018,39,687,480,0,1167
2019,39,796,502,0,1298
2020,39,1049,614,0,1663
2000,40,488,334,0,822
2001,40,481,292,0,773
2002,40,415,243,0,658
2003,40,511,322,0,833
2004,40,452,323,0,775
2005,40,507,326,0,833
2006,40,565,391,0,956
2007,40,518,384,0,902
2008,40,581,363,0,944
2009,40,518,384,0,902
2010,40,582,409,0,991
2011,40,620,407,0,1027
2012,40,645,419,0,1064
2013,40,654,454,0,1108
2014,40,607,424,0,1031
2015,40,564,404,0,968
2016,40,664,417,0,1081
2017,40,811,506,0,1317
2018,40,646,442,0,1088
2019,40,793,511,1,1305
2020,40,1022,596,0,1618
2000,41,482,290,0,772
2001,41,462,333,0,795
2002,41,368,238,0,606
2003,41,487,290,0,777
2004,41,519,394,0,913
2005,41,463,344,0,807
2006,41,655,370,0,1025
2007,41,537,373,0,910
2008,41,576,350,0,926
2009,41,560,376,0,936
2010,41,660,471,0,1131
2011,41,632,358,0,990
2012,41,646,404,0,1050
2013,41,668,425,0,1093
2014,41,677,414,0,1091
2015,41,650,453,0,1103
2016,41,608,438,0,1046
2017,41,781,496,0,1277
2018,41,727,501,0,1228
2019,41,807,600,0,1407
2020,41,998,628,0,1626
2000,42,425,344,0,769
2001,42,481,327,0,808
2002,42,410,299,0,709
2003,42,413,291,0,704
2004,42,436,312,0,748
2005,42,518,346,0,864
2006,42,548,380,0,928
2007,42,546,351,0,897
2008,42,563,387,0,950
2009,42,545,377,0,922
2010,42,649,438,0,1087
2011,42,602,363,0,965
2012,42,646,425,0,1071
2013,42,644,421,0,1065
2014,42,649,338,0,987
2015,42,702,450,0,1152
2016,42,586,394,0,980
2017,42,738,496,0,1234
2018,42,808,483,0,1291
2019,42,792,486,0,1278
2020,42,946,593,0,1539
2000,43,528,360,0,888
2001,43,452,325,0,777
2002,43,437,273,0,710
2003,43,499,318,0,817
2004,43,483,332,0,815
2005,43,534,372,0,906
2006,43,561,386,0,947
2007,43,519,295,0,814
2008,43,606,391,0,997
2009,43,551,372,0,923
2010,43,633,394,0,1027
2011,43,537,381,0,918
2012,43,673,420,0,1093
2013,43,733,447,0,1180
2014,43,677,445,0,1122
2015,43,738,490,0,1228
2016,43,599,396,0,995
2017,43,772,499,0,1271
2018,43,809,565,1,1375
2019,43,865,571,0,1436
2020,43,866,559,0,1425
2000,44,549,324,0,873
2001,44,531,306,0,837
2002,44,454,302,0,756
2003,44,500,315,0,815
2004,44,548,352,0,900
2005,44,683,459,0,1142
2006,44,692,438,0,1130
2007,44,558,395,0,953
2008,44,680,445,0,1125
2009,44,595,374,0,969
2010,44,620,369,0,989
2011,44,640,377,0,1017
2012,44,760,439,0,1199
2013,44,681,424,0,1105
2014,44,727,448,0,1175
2015,44,750,510,0,1260
2016,44,628,413,0,1041
2017,44,754,517,0,1271
2018,44,874,528,0,1402
2019,44,898,614,1,1513
2020,44,859,548,0,1407
2000,45,521,297,0,818
2001,45,495,328,0,823
2002,45,511,308,0,819
2003,45,492,345,0,837
2004,45,585,413,0,998
2005,45,604,450,0,1054
2006,45,665,426,0,1091
2007,45,589,379,0,968
2008,45,690,445,0,1135
2009,45,568,343,0,911
2010,45,680,431,0,1111
2011,45,707,459,0,1166
2012,45,730,497,0,1227
2013,45,734,419,0,1153
2014,45,751,470,0,1221
2015,45,797,559,0,1356
2016,45,659,435,1,1095
2017,45,742,499,0,1241
2018,45,812,592,2,1406
2019,45,884,655,0,1539
2020,45,859,572,1,1432
2000,46,492,356,0,848
2001,46,556,353,0,909
2002,46,609,355,0,964
2003,46,478,295,0,773
2004,46,585,400,0,985
2005,46,718,475,0,1193
2006,46,674,474,0,1148
2007,46,617,406,0,1023
2008,46,655,403,0,1058
2009,46,662,446,0,1108
2010,46,652,414,0,1066
2011,46,758,497,0,1255
2012,46,750,456,0,1206
2013,46,662,470,0,1132
2014,46,761,490,0,1251
2015,46,851,584,0,1435
2016,46,678,460,0,1138
2017,46,832,517,1,1350
2018,46,851,608,1,1460
2019,46,822,571,0,1393
2020,46,876,509,0,1385
2000,47,471,309,0,780
2001,47,503,345,0,848
2002,47,578,354,0,932
2003,47,499,291,0,790
2004,47,515,384,0,899
2005,47,656,461,0,1117
2006,47,649,459,0,1108
2007,47,604,396,0,1000
2008,47,574,416,0,990
2009,47,707,447,0,1154
2010,47,644,421,0,1065
2011,47,667,422,0,1089
2012,47,707,482,0,1189
2013,47,725,462,0,1187
2014,47,708,519,0,1227
2015,47,877,624,0,1501
2016,47,671,438,0,1109
2017,47,783,533,0,1316
2018,47,779,490,0,1269
2019,47,788,511,0,1299
2020,47,870,519,0,1389
2000,48,438,304,0,742
2001,48,520,235,0,755
2002,48,546,330,0,876
2003,48,454,315,0,769
2004,48,543,357,0,900
2005,48,617,455,0,1072
2006,48,632,429,0,1061
2007,48,578,447,0,1025
2008,48,578,419,0,997
2009,48,683,396,0,1079
2010,48,628,407,0,1035
2011,48,660,435,0,1095
2012,48,693,432,0,1125
2013,48,651,435,0,1086
2014,48,711,478,0,1189
2015,48,874,580,0,1454
2016,48,626,447,0,1073
2017,48,760,466,0,1226
2018,48,753,522,1,1276
2019,48,771,549,0,1320
2020,48,889,572,0,1461
2000,49,440,305,0,745
2001,49,512,334,0,846
2002,49,525,302,0,827
2003,49,447,315,0,762
2004,49,552,361,0,913
2005,49,620,433,0,1053
2006,49,585,427,0,1012
2007,49,532,430,0,962
2008,49,592,417,0,1009
2009,49,696,466,0,1162
2010,49,662,414,0,1076
2011,49,644,431,0,1075
2012,49,675,431,0,1106
2013,49,744,451,0,1195
2014,49,761,526,0,1287
2015,49,780,586,0,1366
2016,49,680,452,0,1132
2017,49,715,516,0,1231
2018,49,735,519,1,1255
2019,49,752,526,0,1278
2020,49,905,593,0,1498
2000,50,444,310,0,754
2001,50,504,359,0,863
2002,50,453,331,0,784
2003,50,489,341,0,830
2004,50,502,335,0,837
2005,50,588,406,0,994
2006,50,596,416,0,1012
2007,50,551,377,0,928
2008,50,675,429,0,1104
2009,50,680,470,0,1150
2010,50,655,424,0,1079
2011,50,656,447,0,1103
2012,50,720,445,0,1165
2013,50,749,508,0,1257
2014,50,749,499,0,1248
2015,50,817,604,0,1421
2016,50,766,508,1,1275
2017,50,732,467,1,1200
2018,50,759,511,0,1270
2019,50,824,557,0,1381
2020,50,929,619,1,1549
2000,51,490,321,0,811
2001,51,488,293,0,781
2002,51,478,311,0,789
2003,51,481,311,0,792
2004,51,524,379,0,903
2005,51,616,462,0,1078
2006,51,591,432,0,1023
2007,51,596,410,0,1006
2008,51,580,435,0,1015
2009,51,673,445,0,1118
2010,51,718,429,0,1147
2011,51,676,498,0,1174
2012,51,670,447,0,1117
2013,51,738,523,0,1261
2014,51,686,480,0,1166
2015,51,851,551,0,1402
2016,51,713,502,0,1215
2017,51,764,519,1,1284
2018,51,782,528,0,1310
2019,51,745,548,1,1294
2020,51,921,643,0,1564
2000,52,461,250,0,711
2001,52,565,321,0,886
2002,52,500,362,0,862
2003,52,419,300,0,719
2004,52,603,465,0,1068
2005,52,628,459,0,1087
2006,52,622,406,0,1028
2007,52,628,448,0,1076
2008,52,638,397,0,1035
2009,52,713,471,0,1184
2010,52,758,513,0,1271
2011,52,677,456,0,1133
2012,52,666,393,0,1059
2013,52,693,501,0,1194
2014,52,699,505,0,1204
2015,52,762,533,0,1295
2016,52,761,498,0,1259
2017,52,783,509,0,1292
2018,52,785,541,0,1326
2019,52,735,532,0,1267
2020,52,895,628,0,1523
2000,53,142,100,0,242
2001,53,83,53,0,136
2002,53,76,42,0,118
2003,53,75,51,0,126
2004,53,157,91,0,248
2005,53,84,70,0,154
2006,53,80,51,0,131
2007,53,112,47,0,159
2008,53,180,103,0,283
2009,53,97,81,0,178
2010,53,91,71,0,162
2011,53,108,57,0,165
2012,53,201,135,0,336
2013,53,101,70,0,171
2014,53,111,78,0,189
2015,53,115,96,0,211
2016,53,215,157,0,372
2017,53,108,89,0,197
2018,53,118,66,0,184
2019,53,119,76,0,195
2020,53,268,150,0,418
